Date,Name,Category,Amount,Available_Balance
2025-05-23,Groceries,Food,250.00,2750.00
2025-05-23,Movie Ticket,Entertainment,320.00,2430.00
2025-05-23,Gym membership,Health,1000.00,1430.00
2025-05-23,Mobile recharge,Utilities,299.00,1131.00
2025-05-23,Internet bill,Utilities,450.00,681.00
2025-05-23,Dinner out,Food,320.00,361.00
2025-05-23,Coffee,Food,320.00,41.00
